abrit	- qwer
asrep	- as
adhi	- asdf
kathah	- gh
kula	- zxc
amargi	- a
anak	- wert
enggal	- a
sae	- sdf
badhe	- xcv
badhe	- ert
manah - z
badan	- dfg
badan	- cvb
siyang	- rty
lajeng	- a
toya	- b
bapak	- c
sareng	- d
bathuk	- fgh
sae	- vbn
beda	- tyu
saged	- ghj
lare	- e
semah	- bnm
bokong	- yui
bokong	- hjk
bidhal	- nm
wingking	- f
cepeng	- qwer
alit	- asd
margi	- zxc
kalawau	- wer
yatra	- g
dinten	- h
driji	- sdf
gadhah	- xcv
awon	- ert
awon	- dfg
enem	- cvb
angsal	- rty
enjing	- fgh
ageng	- vbn
geger	- tyu
rah	- ghj
pados	- bnm
ijem	- qwe
cemeng	- asd
grana	- zxc
ulam	- wer
inggih	- sdf
jampi	- xcv
jampi	- ert
sinjang	- dfg
lepen	- a
kepanggih	- b
kengken	- z
sampeyan	- z
kringet	- z
mireng	- z
kedah	- z
jene	- z
kuping	- z
kirang	- z
nembe	- z
lambe	- z
serat	- z
langkung	- z
maos	- z
nedha	- z
tumut	- z
maringi	- z
dhateng	- z
medal	- z
langkung	- z
paningal	- z
mila	- z
wangsul	- z
nginggil	- z
ngapunten	- z
ngajeng	- z
ngatos atos	- z
mbeta	- z
ngandhap	- z
ngunjuk	- z
matur	- z
nimbali	- z
nyuwun	- z
nyerat	- z
numpak - z
griya - z
boten	- z
pijeti	- z
penggalih	- z
pupu	- z
pethak	- z
rai	- z
rambut	- z
werni	- z
sabin	- z
selangkung	- z
dekek	- z
remen	- z
sepalih	- z
suku	- z
sirah	- z
sonten	- z
dangu	- z
nyuwun pirsa - z
jampi - z
tangan - z
nate - z
dugi - z
tumbas - z
serat - z
tilem - z
sepuh - z
jawah - z
untu - z
mawon - z
weteng - z
menda - z
sumerep/mangertos - z
dalu - z
nyukani - z
wanci - z
watuk - z
ringgit - z
waras - z
wahing - z
estri - z
sela - z
ajrih - z